4;4;2;-10;100;;
1;1;1;5;1;1;1
1;1;1;5;1;3;1
1;3;0;1;1;1;1
11;1;1;2;1;1;1
10;1;9;4;1;2;1
1;1;7;4;1;1;1
