4;3;2;-10;100
1;2;1;6;1
1;1;4;3;1
1;4;0;6;1
2;4;1;1;1
1;1;1;3;1
